 █ █████ █████████████ █ █████████ █████ 
█ █     █             █ █         █✅    █
█ █ █ ███ █████ █████ █ █ █████ █ █████ █
█ █ █       █   █ █   █     █   █   █   █
█ █ █████████ ███ █ █████████ █████ █ ██ 
█ █ █ █       █     █       █ █     █   █
█ █ █ █ █████████ █████ ███ █ █ █████ █ █
█ █ █ █         █ █     █     █ █ █   █ █
█ █ █ █████████ █ █ █ █████████ █ █ ███ █
█ █     █   █   █   █ █   █     █   █   █
█ █████ █ █ █ █████ ███ █ █████ █████ █ █
█ █   █ █ █ █     █ █   █     █       █ █
█ █ █ █ ███ █████ █ █ ███████ ██████████ 
█   █ █       █   █ █ █     █ █         █
█ ███ ███████ █ ███ █ ███ █ █ █ ███████ █
█ █     █     █   █ █   █ █ █     █     █
█ █ ███ █ ███████ █████ ███ ███████ ███ █
█ █   █ █   █   █       █   █   █   █   █
█ ███ █████ ███ █████████ █ █ █ █ ███ ██ 
█ █ █     █   █         █ █ █ █ █ █     █
█ █ ███ █████ █ ███████ █ █ ███ █ █████ █
█   █   █   █ █ █    ⭕️█   █     █   █   █
 ████ █ █ █ █ █ █ ████████ ████ ███ ███ █
█     █ █ █   █ █   █     █       █   █ █
█ ███ ███ █████ ███ █ ███ █ █████████ █ █
█ █   █   █       █ █ █ █ █ █       █ █ █
█ █████ ██ ████ ███ █ █ █ ███ █████ █ █ █
█     █   █     █   █ █ █     █ █   █ █ █
 ████ ███ █ ███ █ ███ █ ███████ █ ███ ██ 
█   █   █   █   █ █   █       █   █     █
█ █ ███ █████ ███ ███ █ █████ █ █████ █ █
█ █   █   █   █ █     █ █   █ █ █   █ █ █
█ ███ █ █ █ ███ ███████ █ ███ █ █ █ ███ █
█   █   █ █     █         █   █   █   █ █
 ██ ██████ ████ █ █████████ █ ████ ██ █ █
█   █     █     █       █   █     █ █   █
█ ███ ███ █ █████████████ ███████ █ ████ 
█     █ █   █             █     █ █     █
█ █████ █████ █████████████ ███ █ █████ █
█             █               █         █
 █████████████ ███████████████ █████████ 